..BB...PB.
...P.BP..P
P.B..B.BPB
B.P.PB...P
.......B.B
B..PB..P..
P.........
PB.B.BP.BB
.B.PP....P
.B..BB.BP.
#Nível 20
#POO
#10/03/2021