BBB.PB....
P.........
..B.BP..PB
.PB....B.B
......PP..
BB.PB.BPB.
P.........
..PB...BP.
.P.B....PB
.B.B.PB...
#Nível 7
#POO
#10/03/2021
